Atención los Sábados
Consulado General del Perú en Atlanta
SÁBADOS CONSULARES 2023

Las atenciones sabatinas mensuales,​​ se realizarán solo con cita previa un sábado al mes de 9:00 a.m. a 1:00 p.m. según el cronograma siguiente:​

Enero	S​ábado 21
Febrero	S​ábado 04
Marzo	S​ábado 18
Abril	S​ábado 15
Mayo	S​ábado 06
Junio	S​ábado 03
Julio	S​ábado 22
Agosto	S​ábado 05
Septiembre	Sábado 30
Octubre	Sábado 28
Noviembre	Sábado 11
Diciembre	Sábado 02
Para solicitar una cita, se le agradecerá enviar un correo electrónico a (incluir su nombre completo, número de DNI si lo tuviese, y un celular de contacto)​:

​Tipo de Trámite	​Correo Electrónico
​Poderes, escrituras públicas, legalizaciones	​legal@consulperuatlanta.com
​DNI	​dni@consulperuatlanta.com
​Pasaportes	​pasaportes@consulperuatlanta.com
​Registros civiles (partidas de nacimiento, matrimonio y defunción)	​j.sanchez@consulperuatlanta.com
  
INDICACIONES IMPORTANTES: El día de la cita solo debe acudir al local del Consulado, el titular del trámite consular. Es obligatorio uso de mascarilla.

Esta programación podría ser modificada por el Consulado por motivos de fuerza mayor o cuando existan circunstancias justificadas, incluyendo las de tipo económico o presupuestal.​